Region ID,Region-name,Shortname,Abbrv,Category-ID,Category-Name,LeftCount,RightCount,TotalCount,Color
1,Dorsal motor nucleus of the vagus nerve,Dorsal Mot. Nuc. Vagus,DMX,1,Solitariospinal Area,8,20,28,#FA9600
2,Cuneate nucleus,Cuneate nucleus,CU,1,Solitariospinal Area,101,245,346,#FA9600
3,Gracile nucleus,Gracile nucleus,GR,1,Solitariospinal Area,168,110,278,#FA9600
4,Nucleus of the solitary tract,Nuc. Solitary Tract,NST,1,Solitariospinal Area,220,178,398,#FA9600
5,Medulla,Medulla,MY,1,Solitariospinal Area,188,231,419,#FA9600
6,"Medullary reticular nucleus, ventral part","Medullary Ret. Nuc., ventral",MDRNd,2,Medullary Reticular Nuclei,270,1030,1300,#0000FA
7,"Medullary reticular nucleus, dorsal part","Medullary Ret. Nuc., dorsal",MDRNv,2,Medullary Reticular Nuclei,313,352,665,#0000FA
8,Magnocellular reticular nucleus,Magnocellular Ret. Nuc.,MARN,3,Magnocellular Ret. Nuc.,52,119,171,#003296
9,Gigantocellular reticular nucleus,Gigantocellular Ret. Nuc.,GRN,4,Gigantocellular reticular nucleus,3696,4785,8481,#00FFFF
10,"Lateral reticular nucleus, magnocellular part","Lat. Ret. Nuc., magnocellular",LRNm,5,Lateral Reticular Nuclei,37,88,125,#0096FF
11,"Paragigantocellular reticular nucleus, lateral part","Paragiganto. Ret. Nuc, lateral",PGRNl,5,Lateral Reticular Nuclei,323,281,604,#0096FF
12,Intermediate reticular nucleus,Intermediate Ret. Nuc,IRN,5,Lateral Reticular Nuclei,2197,622,2819,#0096FF
13,Parvicellular reticular nucleus,Parvicellular Ret. Nuc.,PARN,5,Lateral Reticular Nuclei,8,6,14,#0096FF
14,"Paragigantocellular reticular nucleus, dorsal part","Paragigant. Ret. Nuc., dorsal",PGRNd,6,Dorsal Reticular Nucleus,22,58,80,#0064FF
15,Nucleus raphe magnus,Nucleus raphe magnus,RM,7,Raphe Nuclei,199,205,404,#00C8FF
16,Nucleus raphe obscurus,Nucleus raphe obscurus,RO,7,Raphe Nuclei,28,33,61,#00C8FF
17,Facial motor nucleus,Facial motor nucleus,VII,30,Unused,11,13,24,#808080
18,Hypoglossal nucleus,Hypoglossal nucleus,XII,8,Perihypoglossal Area,71,20,91,#C86400
19,Nucleus of Roller,Nucleus of Roller,NR,8,Perihypoglossal Area,2,6,8,#C86400
20,Nucleus prepositus,Nucleus prepositus,PRP,8,Perihypoglossal Area,0,10,10,#C86400
21,"Spinal nucleus of the trigeminal, interpolar part","Spinal Nuc. Trig., interpolar",SPVI,9,Medullary Trigeminal Area,0,0,0,#808080
22,"Spinal nucleus of the trigeminal, caudal part","Spinal Nuc. Trig., caudal",SPVC,9,Medullary Trigeminal Area,3,1,4,#808080
23,Spinal vestibular nucleus,Spinal vestibular nucleus,SPIV,10,Vestibular Nuclei,84,106,190,#462300
24,Medial vestibular nucleus,Medial vestibular nucleus,MV,10,Vestibular Nuclei,47,28,75,#462300
25,Lateral vestibular nucleus,Lateral vestibular nucleus,LAV,10,Vestibular Nuclei,20,5,25,#462300
26,"Pontine reticular nucleus, caudal part","Pontine Ret. Nuc., caudal",PRNc,11,Pontine Reticular Nuclei,601,467,1068,#BEBEBE
27,Pontine reticular nucleus,Pontine reticular nucleus,PRNr,11,Pontine Reticular Nuclei,991,993,1984,#BEBEBE
28,"Superior olivary complex, lateral part","Sup. olivary complex, lateral",SOCl,12,Superior Olivary Complex,4,6,10,#808080
29,"Superior olivary complex, medial part","Sup. olivary complex, medial",SOCm,12,Superior Olivary Complex,6,1,7,#808080
30,"Superior olivary complex, periolivary region","Sup. olivary, periolivary",POR,12,Superior Olivary Complex,7,0,7,#808080
31,Peritrigeminal zone,Peritrigeminal zone,P5,13,Pontine Trigeminal Area,4,0,4,#808080
32,Supratrigeminal nucleus,Supratrigeminal nucleus,SUT,13,Pontine Trigeminal Area,7,16,23,#808080
33,Pontine central gray,Pontine central gray,PGC,14,Pontine Central Gray Area,137,285,422,#AFAF00
34,Sublaterodorsal nucleus,Sublaterodorsal nucleus,SLD,14,Pontine Central Gray Area,104,118,222,#AFAF00
35,Laterodorsal tegmental nucleus,Laterodorsal tegmental Nuc.,LDT,14,Pontine Central Gray Area,109,138,247,#AFAF00
36,Subceruleus nucleus,Subceruleus nucleus,SLC,14,Pontine Central Gray Area,0,0,0,#AFAF00
37,Barrington's nucleus,Barrington's nucleus,B,14,Pontine Central Gray Area,55,34,89,#AFAF00
38,Pons,Pons,P,14,Pontine Central Gray Area,493,549,1042,#AFAF00
39,Locus ceruleus,Locus ceruleus,LC,30,Unused,15,8,23,#808080
40,Parabrachial nucleus,Parabrachial nucleus,PB,15,Parabrachial / Pedunculopontine,7,0,7,#C8C800
41,Pedunculopontine nucleus,Pedunculopontine nucleus,PPN,15,Parabrachial / Pedunculopontine,143,121,264,#C8C800
42,Fastigial nucleus,Fastigial nucleus,FN,16,Cerebellospinal Nuclei,0,0,0,#FF1E96
43,Interposed nucleus,Interposed nucleus,IP,16,Cerebellospinal Nuclei,0,0,0,#FF1E96
44,Red nucleus,Red nucleus,RN,17,Red Nucleus,1151,862,2013,#FFFF00
45,Edinger-Westphal nucleus,Edinger-Westphal nucleus,EW,18,Midbrain Midline Nuclei,1,1,2,#FFE678
46,Interstitial nucleus of Cajal,Interstitial nucleus of Cajal,INC,18,Midbrain Midline Nuclei,39,14,53,#FFE678
47,Nucleus of Darkschewitsch,Nucleus of Darkschewitsch,ND,18,Midbrain Midline Nuclei,4,25,29,#FFE678
48,Midbrain,Midbrain,MB,18,Midbrain Midline Nuclei,29,48,77,#FFE678
49,Midbrain reticular nucleus,Midbrain reticular nucleus,MRN,19,Midbrain Reticular Nuclei,166,225,391,#D2D250
50,"Midbrain reticular nucleus, retrorubral area","Midbrn Ret. Nuc., retrorubral",RR,19,Midbrain Reticular Nuclei,22,17,39,#D2D250
51,Periaqueductal gray,Periaqueductal gray,PAG,20,Periaqueductal Gray,79,157,236,#000000
52,Paraventricular hypothalamic nucleus,Paraventricular Hyp. Nuc.,PVH,21,Hypothalamic Periventricular Zone,164,242,406,#6432A0
53,"Paraventricular hypothalamic nucleus, descending division","Paraventric. Hyp., descend",PVHd,21,Hypothalamic Periventricular Zone,68,99,167,#6432A0
54,"Periventricular hypothalamic nucleus, intermediate part","Periventric. Hyp., interm.",Pvi,21,Hypothalamic Periventricular Zone,0,0,0,#6432A0
55,Dorsomedial nucleus of the hypothalamus,Dorsomedial Nuc.  Hypothal.,DMH,22,Hypothalamic Lateral Area,30,28,58,#8C32A0
56,Hypothalamus,Hypothalamus,HY,22,Hypothalamic Lateral Area,197,252,449,#8C32A0
57,Lateral hypothalamic area,Lateral hypothalamic area,LHA,22,Hypothalamic Lateral Area,238,275,513,#8C32A0
58,Zona incerta,Zona incerta,ZI,22,Hypothalamic Lateral Area,40,68,108,#8C32A0
59,Anterior hypothalamic nucleus,Anterior hypothal. nucleus,AHN,23,Hypothalamic Medial Area,4,1,5,#B432A0
60,Posterior hypothalamic nucleus,Posterior hypothal. nucleus,PH,23,Hypothalamic Medial Area,6,3,9,#B432A0
61,Ventromedial hypothalamic nucleus,Ventromedial Hyp. Nuc.,VMH,23,Hypothalamic Medial Area,4,0,4,#B432A0
62,Perireunensis nucleus,Perireunensis nucleus,PR,24,Thalamus,6,12,18,#808080
63,"Subparafascicular nucleus, magnocellular part","Subparafasc. Nuc., magno.",SPFm,24,Thalamus,15,5,20,#808080
64,Thalamus,Thalamus,TH,24,Thalamus,38,41,79,#808080
65,Ventral medial nucleus of the thalamus,Ventral med.l Nuc. thalamus,VM,24,Thalamus,0,3,3,#808080
66,Nucleus of reuniens,Nucleus of reuniens,RE,24,Thalamus,15,21,36,#808080
67,"Central amygdalar nucleus, medial part","Central amyg. Nuc., medial",CEAm,30,Unused,0,0,0,#808080
68,Substantia innominata,Substantia innominata,SI,30,Unused,0,0,0,#808080
69,Corticospinal,Corticospinal,CST,25,Corticospinal,3920,3570,7490,#009600
